###########
#S#       #
# ##### # #
# #   # # #
# # # ### #
#   #     #
######### #
# #     # #
# # # ### #
#   #    E#
###########
